#################################################################################
# #             #       ##############     #  #             #          #   #    #
# #             #                          #  #               ###        #      #
# ####  ####################################  ###############################   #
#    #          ##########                                                      #           
#    #  #######          #             ###################################      #                                            									
#    #  #                ###############                                 ###    #     								                
#    #  #    ######      #       #      #########                 #        #    #               										
#    #  #                #       #        #                       #             #       										
#    ####  ###############       #        #     #    ############################                                         										
#                          #     #   #    #     #                 #             #    										
#########  #################     #   #    #     #        ##########             #   										
#    #      #                    #   #    #     #                 #   ###########    										
#    #      #    ####       #    #   #          ###########       #   #         #      										
#    #      #               #                             #       #             #     										
#    #      #               ####################   # #    #       ###           #								
#    ######## ############  #                  #   #      #         #           # 										
#                           #                  #   #      #         #    ###  ###            										
#    ########################         #        #####      #  ########    #      #                                										
#    #############################    #                   #         #    #      #                            										
#    #                                #        #####      #     #        #      #          
#    #             ############       #        #   #      #     ##########      #                           
#    ##############           ##      #        #   ########     #      #        #                            
#                                ######        #                       #        #        	
#################################################################################