#################################################################################
# #                                                                             #
# # ########################################################################### #
# # #                                                                         # #
# # # ####################################################################### # #
# # # #                                                                     # # #									
# # # # ################################################################### # # #								                
# # # # #                                                                 # # # #										
# # # # # ############################################################### # # # # 										
# # # # # #                                                             # # # # #										
# # # # # #  ########################################################## # # # # #										
# # # # # #  #                                                        # # # # # #										
# # # # # #  #######################################################  # # # # # #										
# # # # # #                                                           # # # # # #										
# # # # # ############################################################# # # # # #										
# # # # #                                                               # # # # #										
# # # # ################################################################# # # # #										
# # # #                                                                   # # # #										
# # # ##################################################################### # # #										
# # #                                                                       # # #										
# # ######################################################################### # #
# #                                                                           # #
# ############################################################################# #
#                                                                               #	
#################################################################################